10 10 10 10 10 10 10 10 10 10 10 10 10 10
10 10 22 10 10 10 10 10 10 10 10 10 10 10
10 00 00 40 23 10 10 32 10 22 10 10 10 10
10 00 00 00 10 10 21 00 00 00 33 10 10 10
10 21 00 00 22 10 32 00 21 00 00 00 00 10
10 10 30 00 00 33 00 00 33 21 00 50 00 10
10 10 10 30 00 00 00 20 10 10 30 10 10 10
10 10 10 21 00 00 00 33 10 10 10 10 10 10
10 10 10 10 30 00 20 10 10 10 10 10 10 10
10 10 10 10 10 10 10 10 10 10 10 10 10 10