10 10 10 10 10 10 10 10 10 10 10 10 10 10 10 10
10 10 22 10 10 21 50 00 32 10 10 10 10 10 10 10
10 10 40 22 10 10 31 00 00 32 22 10 10 10 10 10
10 21 00 00 00 33 10 31 00 00 00 33 10 10 10 10
10 10 00 00 23 10 10 10 32 00 00 22 10 10 10 10
10 21 00 00 00 33 22 21 00 00 00 00 33 32 10 10
10 10 30 21 00 00 00 33 00 20 30 00 21 00 50 10
10 10 10 10 30 21 00 00 00 33 21 00 00 00 33 10
10 10 10 10 10 10 00 00 20 10 10 30 00 00 10 10
10 10 10 10 10 10 10 10 10 10 10 10 10 10 10 10