10 10 10 10 10 10 10 10
10 10 22 10 10 10 10 10
10 31 00 00 40 23 10 10
10 10 00 22 00 32 10 10
10 21 00 00 50 00 23 10
10 10 30 00 00 00 10 10
10 10 21 00 00 00 33 10
10 10 10 30 10 20 10 10
10 10 10 10 10 10 10 10