10 10 10 10 10 10 10 10 10 10 10 10 10 10 10 10
10 10 22 10 10 10 00 00 00 00 00 00 00 00 00 10
31 00 40 33 10 10 00 00 00 00 00 00 00 00 00 10
10 21 00 00 10 10 00 00 00 00 00 00 00 00 00 10
10 10 00 00 23 10 00 00 00 00 00 00 00 00 00 10
10 21 00 00 00 33 00 00 00 00 00 00 00 00 00 10
10 10 30 10 00 10 00 00 00 00 00 00 00 00 00 10
10 10 10 10 30 10 00 00 00 00 00 00 00 00 00 10
10 10 10 10 10 10 00 00 00 00 00 00 00 00 00 10
10 10 10 10 10 10 10 10 10 10 10 10 10 10 10 10